11111111111111111111111111
10000000000C000000000000C1
1C00011111C001C00011111C01
100P11C000000100011E000001
10000000000C010000000000C1
10000000000C010000000000C1
10000000000C010000000000C1
10000000000C010000000000C1
10000000000C010000000000C1
10000000000C010000000000C1
10000000000C010000000000C1
10000000000C010000000000C1
10000000000C010000000000C1
10000000000C010000000000C1
11111111111111111111111111