111111111111111111111111111111
1P0000000000C000000000000000E1
100001111111111111111110000001
100000000000000000000000000001
100000111111111111111110000001
1000000000000000000000C0000001
100001111111111111111110000001
100000000000000000000000000001
100000C00000000000000000000001
100001111111111111111110000001
100000000000000000000000000001
100000111111111111111110000001
1C0000000000000000000000000001
100001111111111111111110000001
1C0000000000000000000000000001
111111111111111111111111111111