111111111111111111111111111111
1P0111000000000100010001100011
110100011111000001000100001011
1000011000C1111111110111111001
101111001110000000000100001101
10000100000110101111111011E001
11110111000010100000C010101111
100000000111101111111110101001
101111110000101000100010101011
100000111110111101011010101001
101111100000100000000010101101
101000101110111101111010101101
101011101000100000C00000000101
100C10001011101111111111010001
111111111000000000000000010111
111111111111111111111111111111