1111111111111
10000000000C1
1C00011111C01
100P11E000001
1111111111111